F.	:Vergleichendes Wörterbuch der indogermanischen Sprachen— Fick, 1870	:1
C.	:Grundzüge der griechischen Etymologie— Georg Curtius, 1858	:2
Iliad— Homer	:Iliad of Homer	:1
Ait. Br.	:Aitareya Brāhmaṇa, Aufrecht, 1879	:4
AK.	:Amarakośa	:1
Anukramaṇikā	:Rig-Veda Anukramaṇikā	:1
Aufr.	:[Aufrechtʼs edition of Rig-Veda]	:23
Aufrecht	:[Aufrechtʼs edition of Rig-Veda]	:5
Ausgabe von Ro. Whi.	:[Roth & Whitneyʼs edition of Atharvaveda]	:1
AV.	:[Atharvaveda— Roth & Whitneyʼs edition]	:296
Be. SV. gl.	:Glossar zum Sāma-Veda, App. to Die Hymnen des Sâma-Veda mit Glossar— Benfey, 1848	:1
Be. SV. gloss.	:Glossar zum Sāma-Veda, App. to Die Hymnen des Sâma-Veda mit Glossar— Benfey, 1848	:2
Be. vollst. Gramm.	:Vollständige Grammatik der Sanskrit Sprache— Benfey, 1852	:1
Benfey	:Glossar zum Sāma-Veda, App. to Die Hymnen des Sâma-Veda mit Glossar— Benfey, 1848	:1
Benfey (S. V. glo.)	:Glossar zum Sāma-Veda, App. to Die Hymnen des Sâma-Veda mit Glossar— Benfey, 1848	:1
BR	:(Petersburger) Sanskrit-Wörterbuch— Böhtlingk und Roth	:4
BR.	:(Petersburger) Sanskrit-Wörterbuch— Böhtlingk und Roth	:304
Ch. 60	:Chambers 60 [Rigveda Padapāṭha Aṣṭakas 1-4, Chambersʼ Manuscripts collection No. 60]	:1
Chamb. 60	:Chambers 60 RigvedaṚgveda Padapāṭha Aṣṭakas 1-4, Chambersʼ Manuscripts collection No. 60]	:2
Chambers 60	:Chambers 60 [Rigveda Padapāṭha Aṣṭakas 1-4, Chambersʼ Manuscripts collection No. 60]	:4
ms. Chambers 60	:Chambers manuscript 60 [Rigveda Padapāṭha Aṣṭakas 1-4, Chambersʼ Manuscripts collection No. 60]	:1
Cod. Chambers 60	:(Codice) Chambers 60 [Rigveda Padapāṭha Aṣṭakas 1-4, Chambersʼ Manuscripts collection No. 60]	:2
Cod. Chambers 61	:(Codice) Chambers 61 [Rigveda Padapāṭha Aṣṭakas 5-8, Chambersʼ Manuscripts collection No. 61]	:1
Cu.	:Grundzüge der griechischen Etymologie— Georg Curtius, 1858	:355
Curt.	:Grundzüge der griechischen Etymologie— Georg Curtius, 1858	:2
Curtius	:Grundzüge der griechischen Etymologie— Georg Curtius, 1858	:2
Delbr.	:Das altindische verbum aus den hymnen des Rigveda seinem baue nach dargestellt— Delbrück, 1874	:1
Delbr., Gebr. des Co. und Opt.	:Der Gebrauch des Conjunctivs und Optativs im Sanskrit und Griechischen— Delbrück, 1871	:1
Delbrück: das altindische Verbum	:Das altindische verbum aus den hymnen des Rigveda seinem baue nach dargestellt— Delbrück, 1874	:1
Deutsche Pflanzennamen	:Deutsche Pflanzennamen— Hermann Grassmann, 1870	:4
Deutsche Pflanzennamen vom Verf.	:Deutsche Pflanzennamen— Hermann Grassmann, 1870	:1
Dhātup.	:Pāṇiniʼs Dhātupāṭha, App. to Radices linguae Sanscritae— Westergaard, 1841	:1
Dhātupāṭha Westerg.	:Pāṇiniʼs Dhātupāṭha, App. to Radices linguae Sanscritae— Westergaard, 1841	:1
Druckfehler der Aufrecht'schen Ausgabe	:[Misprint in Aufrechtʼs edition]	:1
Fi.	:Vergleichendes Wörterbuch der indogermanischen Sprachen— Fick, 1870	:70
Fi. in Ku. Z.	:Etymologische beiträge.— Fickʼs Article in Kuhnʼs Zeitschrift	:1
Fick	:Vergleichendes Wörterbuch der indogermanischen Sprachen— Fick, 1870	:15
Glosse des Hesychius	:Hesychii Alexandrini lexicon— Mauricious Schmidt, 1861	:1
Gr. gr.	:Grundzüge der griechischen Etymologie— Georg Curtius, 1858	:1
Hesychius	:Hesychii Alexandrini lexicon— Mauricious Schmidt, 1861	:1
Hom.	:Odyssey— Homer	:1
Homer	:Odyssey & Iliad— Homer	:1
Jenaer Literaturzeitung 1874	:Jenaer Literaturzeitung 1874 [Vienna University Newspaper, 1874]	:1
Johannes Schmidt: Die Wurzel ak	:Die Wurzel ak im Indogermanischen— Dr. Johannes Schmidt, 1865	:1
Justi	:Handbuch Der Zendsprache— Ferdinand Justi, 1864	:1
Justi Handb. d. Zend.	:Handbuch Der Zendsprache— Ferdinand Justi, 1864	:1
Justi Zend.	:Handbuch Der Zendsprache— Ferdinand Justi, 1864	:1
Justi Zendspr.	:Handbuch Der Zendsprache— Ferdinand Justi, 1864	:1
Kir.	:Kirātārjunīya, Calcutta ed., 1814	:1
Ku.	:Kuhnʼs Zeitschrift	:24
Ku. Z.	:Kuhnʼs Zeitschrift	:4
Ku. Zeitschr.	:Kuhnʼs Zeitschrift	:38
Kuhn Z.	:Kuhnʼs Zeitschrift	:1
Kuhn Ztschr.	:Kuhnʼs Zeitschrift	:1
Kuhn's Zeitschr.	:Kuhnʼs Zeitschrift	:5
M. Müller	:Max Müllerʼs edition of Rig-Veda	:4
Mah.	:Mahābhārata, Calcutta ed., 1834—9	:1
MBh.	:Mahābhārata, Calcutta ed., 1834—9	:1
Mitrahymnus	:[Hymns to Mitra (and others)]	:1
Müller	:Max Müllerʼs edition of Rig-Veda	:1
Naigh.	:Naighaṇṭukakāṇḍa [Yāskaʼs Nirukta]	:21
Nir.	:Jâskaʼs Nirukta, sammt den Nighaṇṭavas— Rudolf Roth, 1852 [Yāskaʼs Nirukta]	:12
O. u. O.	:Orient und Occident	:1
Oxford Essays	:Oxford Essays— Max Müller, 1856	:1
P.	:Padapāṭha	:25
Pad.	:Padapāṭha	:167
Pada	:Padapāṭha	:73
Pada bei Aufr.	:Padapāṭha, Aufrechtʼs edition	:1
Padap.	:Padapāṭha	:7
Padapāṭha	:Padapāṭha	:2 
Pauli, Körpertheile	:Ueber die Benennung der Körpertheile bei den Indogermanen— Carl Pauli, 1867	:1
Pet. Wörtb.	:Petersburger (Sanskrit-)Wörterbuch— Böhtlingk und Roth	:1
Prāt.	:(Rig-Veda) Prātiśākhya	:142
Pāṇ.	:Aṣṭādhyāya— Pāṇini 	:16
Pāṇini	:Aṣṭādhyāya— Pāṇini	:1
Roth	:?? (Roth, in his Nirukta ed. 1852)	:4
Roth Erl. zu Nirukta	:Rothʼs Erläuterungen[Rothʼs explanations] zu Nirukta	:1
Roth Nir.	:Jâskaʼs Nirukta, sammt den Nighaṇṭavas— Rudolf Roth, 1852 [Yāskaʼs Nirukta]	:2
Roth zu Nir.	:Roth, in his Nirukta ed. 1852	:3
Roth's Erläuterungen	:[Roth's Erläuterungen zu Nirukta]	:1
RV	:Rig-Veda	:56
RV.	:Rig-Veda	:65
RV. Pr.	:Rig-Veda Prātiśākhya	:1
RV. Prātiś.	:Rig-Veda Prātiśākhya	:1
RV. Prātiś. M. M.	:Rig-Veda Prātiśākhya, Max Müllerʼs edition	:1
Spr.	:Indische Sprüche— Böhtlingk, 1863	:1
SV.	:Die Hymnen des Sâma-Veda— Benfey, 1848	:189
Benfey SV.	:Die Hymnen des Sâma-Veda— Benfey, 1848	:1
SV. gl.	:Glossar zum Sāma-Veda, App. to Die Hymnen des Sâma-Veda mit Glossar— Benfey, 1848	:1
Sāy.	:Sāyaṇaʼs Commentary to Rig-Veda	:75
TBr.	:Taittirīya Brāhmaṇa— Rajendralala Mitra, 1859—90	:4
Text	:Rigveda Saṃhitā Text	:49
TS.	:Taittirīya Saṃhitā— Weber, 1871	:17
Verf. Deutsche Pflanzennamen	:Deutsche Pflanzennamen— Hermann Grassmann, 1870	:1
Vop.	:Vopadevaʼs Mugdhabodha— Böhtlingk, 1847	:2
VS.	:Vājasaneyi Saṃhitā— Weber, 1852	:67
Weber, Ind. St.	:Indische Studien— Weber	:1
Zeitschr.	:Kuhnʼs Zeitschrift	:2
Śat. Br.	:Śatapatha Brāhmaṇa— Weber, 1855	:18
Aufr. in Ku.	:ὕμνος.— Aufrechtʼs Article in Kuhnʼs Zeitschrift	:1
Aufr. in Ku. Z.	:Einige seltnere suffixe.— Aufrechtʼs Article in Kuhnʼs Zeitschrift	:1
Aufr. in Ku. Zeitschr.	:Lateinische etymologieen.— Aufrechtʼs Article in Kuhnʼs Zeitschrift	:1
Aufr. in Ku. Zeitschr.&#xA0;	:Deutsche wortdeutungen. 5) sigis.— Aufrechtʼs Article in Kuhnʼs Zeitschrift	:1
Aufr. in Ku. Zeitschr.&#xA0;&#xA0;	:Etymologien.— Aufrechtʼs Article in Kuhnʼs Zeitschrift	:1
Aufr. in Zeitschr. der morg. G.	:Erklärung vedischer Wörter— Aufrechtʼs Article in ZDMG	:1
Aufr. Ku.	:Auhns.— Aufrechtʼs Article in Kuhnʼs Zeitschrift	:1
Aufrecht in Kuhn's Zeitschr.	:Panzerbeiter, quaestiones umbricae.— Aufrechtʼs Article in Kuhnʼs Zeitschrift	:1
Aufrecht in Kuhn's Zeitschr.&#xA0;	:Auhns.— Aufrechtʼs Article in Kuhnʼs Zeitschrift	:1
Be.	:Benfey	:1
Be., Or. u. Occ.	:Uebersetzung d. Rig-Veda (Hymn. 1-35)— Benfeyʼs Article in Orient und Occident	:1
Benf. in Or. und Occ.	:Sanskritisch Sarvátâti, zendisch haurvatât, lateinisch sălût.— Benfeyʼs Article in Orient und Occident	:1
Benfey in Gött. gel. Anz.	:Berichtigung.— Benfeyʼs correction in Göttingische Gelehrte Anzeigen	:1
Benfey in Ku.	:Πεϱνα in πέϱνημι und sanskritisch paṇ, paṇi und verwandts.— Benfeyʼs Article in Kuhnʼs Zeitschrift	:1
Benfey Or. und Occ.	:Uebersetzung d. Rig-Veda (Hymn. 1-35)— Benfeyʼs Article in Orient und Occident	:1
Boll.	:Zur Herstellung des Veda.— Bollensenʼs Article in Orient und Occident	:1
Boll. Or. u. Occ.	:Zur Herstellung des Veda.— Bollensenʼs Article in Orient und Occident	:1
Bollens.	:Zur Herstellung des Veda.— Bollensenʼs Article in Orient und Occident	:2
Bollensen	:Zur Herstellung des Veda.— Bollensenʼs Article in Orient und Occident	:7
Bollensen in Orient und Occ.	:Zur Herstellung des Veda.— Bollensenʼs Article in Orient und Occident	:2
Bollensen O. und O.	:Zur Herstellung des Veda.— Bollensenʼs Article in Orient und Occident	:1
Bugge in Ku.	:Zur etymologischen wortforschung.— Baggeʼs Article in Kuhnʼs Zeitschrift	:4
Bugge in Ku. Zeitschr.	:Zur etymologischen wortforschung.— Baggeʼs Article in Kuhnʼs Zeitschrift	:6
Goldschmidt in Beitr.	:Etymologien. 1. chromŭ - srāma; 2. juvā́ku— Goldschmidtʼs Article in Beiträge zur vergleichenden Sprachforschung	:1
Goldschmidt in Beiträge	:Etymologien. 1. chromŭ - srāma; 2. juvā́ku— Goldschmidtʼs Article in Beiträge zur vergleichenden Sprachforschung	:1
J. Grimm	:SCADO— Jacob Grimmʼs Article in Kuhnʼs Zeitschrift	:1
Ku. Beitr.	:Wechsel von am und u im sanskrit— Kuhnʼs Article in Beiträge zur vergleichenden Sprachforschung	:1
Ku. in Zeitschr.	:Ueber des alte S und einige damit verbundene lautentwicklungen (5ter artikel)— Kuhnʼs Article in Kuhnʼs Zeitschrift	:1
Ku. in Zeitschr.&#xA0;	:Kuhnʼs two Articles in Kuhnʼs Zeitschrift	:1
Kuhn in Haupt Zeitschr.	:Zur mythologie— Kuhnʼs Article in Hauptʼs Zeitschrift (Zeitschrift für Deutsches Altertum)	:1
Kuhn in Zeitschr.	:Die neutra auf as— Kuhnʼs Article in Kuhnʼs Zeitschrift	:1
Lottner	:Ueber die stellung der Italer innerhalb des indoeuropäischen stammes (schlufs)— Lottnerʼs Article in Kuhnʼs Zeitschrift	:1
Lottner in Ku. Z.	:Griechische ableitungen vom stamme des relativums— Lottnerʼs Article in Kuhnʼs Zeitschrift	:1
Max Müller	:Oxford Essays— Max Müller, 1856	:1
Max Müller the sixth hymn	:The Sixth Hymn of the First Book of the Rig Veda— Max Müllerʼs Article in JRAS of Great Britain and Ireland, New Series, Vol. 3, No. 1 (1867)	:3
Pauli in Ku. Zeitschr.	:Ueber skr. hāridravá— Carl Pauliʼs Article in Kuhnʼs Zeitschrift	:1
Pictet in Ku. Zeitschr.	:Etymologische forschungen über die älteste arzneikunst bei den Indogermanen.— Adolphe Pictetʼs Article in Kuhnʼs Zeitschrift	:1
Roth in Ku.	:Etymologien.— Rothʼs Article in Kuhnʼs Zeitschrift	:4
Roth in Ku.&#xA0;	:Zu Benfey: Ueber die entstehong und verwendnng der im sanskrit mit r anlantenden personalendungeo.— Rothʼs Article in Kuhnʼs Zeitschrift	:1
Sonne in Ku.	:Charis.— Sonneʼs Article in Kuhnʼs Zeitschrift	:1
Sonne in Ku. Zeitschr.	:Sprachliche und mythologische untersuchungen, angeknüpft an Rigveda I, 50.— Sonneʼs Article in Kuhnʼs Zeitschrift	:1
Web. in Ku.	:Weberʼs two Articles in Kuhnʼs Zeitschrift	:1
