Aufr. in Ku.	:<ls n="ὕμνος.— Aufrechtʼs Article in Kuhnʼs Zeitschrift">Aufr. in Ku.</ls>	:1
Aufr. in Ku. Z.	:<ls n="Einige seltnere suffixe.— Aufrechtʼs Article in Kuhnʼs Zeitschrift">Aufr. in Ku. Z.</ls>	:1
Aufr. in Ku. Zeitschr.	:<ls n="Deutsche wortdeutungen. 5) sigis.— Aufrechtʼs Article in Kuhnʼs Zeitschrift">Aufr. in Ku. Zeitschr.</ls>	:1
Aufr. in Ku. Zeitschr.	:<ls n="Etymologien.— Aufrechtʼs Article in Kuhnʼs Zeitschrift">Aufr. in Ku. Zeitschr.</ls>	:1
Aufr. in Ku. Zeitschr.	:<ls n="Lateinische etymologieen.— Aufrechtʼs Article in Kuhnʼs Zeitschrift">Aufr. in Ku. Zeitschr.</ls>	:1
Aufr. in Zeitschr. der morg.	:<ls n="Erklärung vedischer Wörter— Aufrechtʼs Article in Zeitschrift der Deutschen Morgenländischen Gesellschaft">Aufr. in Zeitschr. der morg.</ls>	:1
Aufr. Ku.	:<ls n="Auhns.— Aufrechtʼs Article in Kuhnʼs Zeitschrift">Aufr. Ku.</ls>	:1
Aufrecht in Kuhn's Zeitschr.	:<ls n="Auhns.— Aufrechtʼs Article in Kuhnʼs Zeitschrift">Aufrecht in Kuhn's Zeitschr.</ls>	:1
Aufrecht in Kuhn's Zeitschr.	:<ls n="Panzerbeiter, quaestiones umbricae.— Aufrechtʼs Article in Kuhnʼs Zeitschrift">Aufrecht in Kuhn's Zeitschr.</ls>	:1
Be.	:<ls n="Benfey">Be.</ls>	:1
Be., Or. u. Occ.	:<ls n="Uebersetzung d. Rig-Veda (Hymn. 1-35)— Benfeyʼs Article in Orient und Occident">Be., Or. u. Occ.</ls>	:1
Benf. in Or. und Occ.	:<ls n="Sanskritisch Sarvátâti, zendisch haurvatât, lateinisch sălût.— Benfeyʼs Article in Orient und Occident">Benf. in Or. und Occ.</ls>	:1
Benfey in Gött. gel. Anz. 1873	:<ls n="Benfeyʼs Correction (Berichtigung) in Göttingische Gelehrte Anzeigen, 1873">Benfey in Gött. gel. Anz. 1873</ls>	:1
Benfey in Ku.	:<ls n="Πεϱνα in πέϱνημι und sanskritisch paṇ, paṇi und verwandts.— Benfeyʼs Article in Kuhnʼs Zeitschrift">Benfey in Ku.</ls>	:1
Benfey Or. und Occ.	:<ls n="Uebersetzung d. Rig-Veda (Hymn. 1-35)— Benfeyʼs Article in Orient und Occident">Benfey Or. und Occ.</ls>	:1
Boll.	:<ls n="Zur Herstellung des Veda.— Bollensenʼs Article in Orient und Occident">Boll.</ls>	:1
Boll. Or. u. Occ.	:<ls n="Zur Herstellung des Veda.— Bollensenʼs Article in Orient und Occident">Boll. Or. u. Occ.</ls>	:1
Bollens.	:<ls n="Zur Herstellung des Veda.— Bollensenʼs Article in Orient und Occident">Bollens.</ls>	:2
Bollensen	:<ls n="Zur Herstellung des Veda.— Bollensenʼs Article in Orient und Occident">Bollensen</ls>	:7
Bollensen in Orient und Occ.	:<ls n="Zur Herstellung des Veda.— Bollensenʼs Article in Orient und Occident">Bollensen in Orient und Occ.</ls>	:2
Bollensen O. und O.	:<ls n="Zur Herstellung des Veda.— Bollensenʼs Article in Orient und Occident">Bollensen O. und O.</ls>	:1
Bugge in Ku.	:<ls n="Zur etymologischen wortforschung.— Baggeʼs Article in Kuhnʼs Zeitschrift">Bugge in Ku.</ls>	:4
Bugge in Ku. Zeitschr.	:<ls n="Zur etymologischen wortforschung.— Baggeʼs Article in Kuhnʼs Zeitschrift">Bugge in Ku. Zeitschr.</ls>	:6
C.	:<ls n="Grundzüge der griechischen Etymologie— Georg Curtius, 1858">C.</ls>	:2
F.	:<ls n="Vergleichendes Wörterbuch der indogermanischen Sprachen— Fick, 1870">F.</ls>	:1
J. Grimm	:<ls n="SCADO— Jacob Grimmʼs Article in Kuhnʼs Zeitschrift">J. Grimm</ls>	:1
Ku. Beitr.	:<ls n="?? Kuhnʼs Article in Beiträge">Ku. Beitr.</ls>	:1
Ku. in Zeitschr.	:<ls n="Kuhnʼs two Articles in Kuhnʼs Zeitschrift">Ku. in Zeitschr.</ls>	:2
Kuhn in Haupt Zeitschr.	:<ls n="??">Kuhn in Haupt Zeitschr.</ls>	:1
Kuhn in Zeitschr.	:<ls n="?? Kuhnʼs Article in Kuhnʼs Zeitschrift">Kuhn in Zeitschr.</ls>	:1
Lottner in Ku. Z.	:<ls n="Griechische ableitungen vom stamme des relativums— Lottnerʼs Article in Kuhnʼs Zeitschrift">Lottner in Ku. Z.</ls>	:1
Pauli in Ku. Zeitschr.	:<ls n="Ueber skr. hāridravá— Carl Pauliʼs Article in Kuhnʼs Zeitschrift">Pauli in Ku. Zeitschr.</ls>	:1
Pictet in Ku. Zeitschr.	:<ls n="Etymologische forschungen über die älteste arzneikunst bei den Indogermanen.— Adolphe Pictetʼs Article in Kuhnʼs Zeitschrift">Pictet in Ku. Zeitschr.</ls>	:1
Roth in Ku.	:<ls n="Etymologien.— Rothʼs Article in Kuhnʼs Zeitschrift">Roth in Ku.</ls>	:4
Roth in Ku.	:<ls n="Zu Benfey: Ueber die entstehong und verwendnng der im sanskrit mit r anlantenden personalendungeo.— Rothʼs Article in Kuhnʼs Zeitschrift">Roth in Ku.</ls>	:1
Sonne in Ku.	:<ls n="Charis.— Sonneʼs Article in Kuhnʼs Zeitschrift">Sonne in Ku.</ls>	:1
Sonne in Ku. Zeitschr.	:<ls n="Sprachliche und mythologische untersuchungen, angeknüpft an Rigveda I, 50.— Sonneʼs Article in Kuhnʼs Zeitschrift">Sonne in Ku. Zeitschr.</ls>	:1
Web. in Ku.	:<ls n="Weberʼs two Articles in Kuhnʼs Zeitschrift">Web. in Ku.</ls>	:1
